1111111111111
1CE10000000E1
1000M11111001
10P011C000001
1111111111111