1111111111111
1CE10000000E1
1M00M11111001
10P0110000001
1111111111111